type octile
height 5
width 5
map
.TTTT
.TTTT
....T
.TTTT
.TTTT


