type octile
height 5
width 5
map
.TTTT
..TTT
....T
..TTT
.TTTT


